"filename", "language", "C#", "XML", "JSON", "Properties", "comment", "blank", "total"
"c:\Users\Lemuel\VsCodeProjects\FEM-RAFA\RAFAAPI\.vs\ReportAFaultAPI\project-colors.json", "JSON", 0, 0, 11, 0, 0, 0, 11
"c:\Users\Lemuel\VsCodeProjects\FEM-RAFA\RAFAAPI\ReportAFaultAPI\.config\dotnet-tools.json", "JSON", 0, 0, 12, 0, 0, 0, 12
"c:\Users\Lemuel\VsCodeProjects\FEM-RAFA\RAFAAPI\ReportAFaultAPI\Controllers\Constants.cs", "C#", 9, 0, 0, 0, 0, 1, 10
"c:\Users\Lemuel\VsCodeProjects\FEM-RAFA\RAFAAPI\ReportAFaultAPI\Controllers\RAFABuildingController.cs", "C#", 165, 0, 0, 0, 10, 13, 188
"c:\Users\Lemuel\VsCodeProjects\FEM-RAFA\RAFAAPI\ReportAFaultAPI\Controllers\RAFAFaultReportsController.cs", "C#", 92, 0, 0, 0, 124, 9, 225
"c:\Users\Lemuel\VsCodeProjects\FEM-RAFA\RAFAAPI\ReportAFaultAPI\Controllers\RAFAOTPsController.cs", "C#", 318, 0, 0, 0, 95, 37, 450
"c:\Users\Lemuel\VsCodeProjects\FEM-RAFA\RAFAAPI\ReportAFaultAPI\Controllers\RAFARecaptchaController.cs", "C#", 52, 0, 0, 0, 0, 7, 59
"c:\Users\Lemuel\VsCodeProjects\FEM-RAFA\RAFAAPI\ReportAFaultAPI\Controllers\RAFAReportStatusController.cs", "C#", 0, 0, 0, 0, 42, 7, 49
"c:\Users\Lemuel\VsCodeProjects\FEM-RAFA\RAFAAPI\ReportAFaultAPI\Migrations\20220831065640_InitialCreate.Designer.cs", "C#", 180, 0, 0, 0, 1, 56, 237
"c:\Users\Lemuel\VsCodeProjects\FEM-RAFA\RAFAAPI\ReportAFaultAPI\Migrations\20220831065640_InitialCreate.cs", "C#", 130, 0, 0, 0, 0, 13, 143
"c:\Users\Lemuel\VsCodeProjects\FEM-RAFA\RAFAAPI\ReportAFaultAPI\Migrations\RafaDbContextModelSnapshot.cs", "C#", 178, 0, 0, 0, 1, 56, 235
"c:\Users\Lemuel\VsCodeProjects\FEM-RAFA\RAFAAPI\ReportAFaultAPI\Models\RAFAFaultImage.cs", "C#", 10, 0, 0, 0, 0, 0, 10
"c:\Users\Lemuel\VsCodeProjects\FEM-RAFA\RAFAAPI\ReportAFaultAPI\Models\RAFAFaultReport.cs", "C#", 53, 0, 0, 0, 0, 15, 68
"c:\Users\Lemuel\VsCodeProjects\FEM-RAFA\RAFAAPI\ReportAFaultAPI\Models\RAFAOTP.cs", "C#", 19, 0, 0, 0, 0, 3, 22
"c:\Users\Lemuel\VsCodeProjects\FEM-RAFA\RAFAAPI\ReportAFaultAPI\Models\RAFASmsLog.cs", "C#", 14, 0, 0, 0, 0, 3, 17
"c:\Users\Lemuel\VsCodeProjects\FEM-RAFA\RAFAAPI\ReportAFaultAPI\Models\RafaDbContext.cs", "C#", 12, 0, 0, 0, 0, 7, 19
"c:\Users\Lemuel\VsCodeProjects\FEM-RAFA\RAFAAPI\ReportAFaultAPI\Program.cs", "C#", 24, 0, 0, 0, 0, 3, 27
"c:\Users\Lemuel\VsCodeProjects\FEM-RAFA\RAFAAPI\ReportAFaultAPI\Properties\PublishProfiles\FolderProfile.pubxml", "XML", 0, 13, 0, 0, 3, 0, 16
"c:\Users\Lemuel\VsCodeProjects\FEM-RAFA\RAFAAPI\ReportAFaultAPI\Properties\PublishProfiles\FolderProfile1.pubxml", "XML", 0, 13, 0, 0, 3, 0, 16
"c:\Users\Lemuel\VsCodeProjects\FEM-RAFA\RAFAAPI\ReportAFaultAPI\Properties\ServiceDependencies\jtcfemapp - Web Deploy\mssql1.arm.json", "JSON", 0, 0, 81, 0, 0, 0, 81
"c:\Users\Lemuel\VsCodeProjects\FEM-RAFA\RAFAAPI\ReportAFaultAPI\Properties\ServiceDependencies\jtcfemapp - Web Deploy\profile.arm.json", "JSON", 0, 0, 113, 0, 0, 0, 113
"c:\Users\Lemuel\VsCodeProjects\FEM-RAFA\RAFAAPI\ReportAFaultAPI\Properties\launchSettings.json", "JSON", 0, 0, 32, 0, 0, 0, 32
"c:\Users\Lemuel\VsCodeProjects\FEM-RAFA\RAFAAPI\ReportAFaultAPI\Properties\serviceDependencies.json", "JSON", 0, 0, 8, 0, 0, 0, 8
"c:\Users\Lemuel\VsCodeProjects\FEM-RAFA\RAFAAPI\ReportAFaultAPI\Properties\serviceDependencies.jtcfemapp - Web Deploy.json", "JSON", 0, 0, 10, 0, 0, 0, 10
"c:\Users\Lemuel\VsCodeProjects\FEM-RAFA\RAFAAPI\ReportAFaultAPI\ReportAFaultAPI.csproj", "XML", 0, 25, 0, 0, 0, 4, 29
"c:\Users\Lemuel\VsCodeProjects\FEM-RAFA\RAFAAPI\ReportAFaultAPI\Startup.cs", "C#", 109, 0, 0, 0, 7, 13, 129
"c:\Users\Lemuel\VsCodeProjects\FEM-RAFA\RAFAAPI\ReportAFaultAPI\WeatherForecast.cs", "C#", 11, 0, 0, 0, 0, 5, 16
"c:\Users\Lemuel\VsCodeProjects\FEM-RAFA\RAFAAPI\ReportAFaultAPI\appsettings.Development.json", "JSON", 0, 0, 9, 0, 0, 1, 10
"c:\Users\Lemuel\VsCodeProjects\FEM-RAFA\RAFAAPI\ReportAFaultAPI\appsettings.json", "JSON", 0, 0, 53, 0, 1, 0, 54
"c:\Users\Lemuel\VsCodeProjects\FEM-RAFA\RAFAAPI\ReportAFaultAPI\bin\Debug\net6.0\ReportAFaultAPI.deps.json", "JSON", 0, 0, 4010, 0, 0, 0, 4010
"c:\Users\Lemuel\VsCodeProjects\FEM-RAFA\RAFAAPI\ReportAFaultAPI\bin\Debug\net6.0\ReportAFaultAPI.runtimeconfig.json", "JSON", 0, 0, 20, 0, 0, 0, 20
"c:\Users\Lemuel\VsCodeProjects\FEM-RAFA\RAFAAPI\ReportAFaultAPI\bin\Debug\net6.0\appsettings.Development.json", "JSON", 0, 0, 9, 0, 0, 1, 10
"c:\Users\Lemuel\VsCodeProjects\FEM-RAFA\RAFAAPI\ReportAFaultAPI\bin\Debug\net6.0\appsettings.json", "JSON", 0, 0, 53, 0, 1, 0, 54
"c:\Users\Lemuel\VsCodeProjects\FEM-RAFA\RAFAAPI\ReportAFaultAPI\bin\Release\net5.0\ReportAFaultAPI.deps.json", "JSON", 0, 0, 6985, 0, 0, 0, 6985
"c:\Users\Lemuel\VsCodeProjects\FEM-RAFA\RAFAAPI\ReportAFaultAPI\bin\Release\net5.0\ReportAFaultAPI.runtimeconfig.dev.json", "JSON", 0, 0, 10, 0, 0, 0, 10
"c:\Users\Lemuel\VsCodeProjects\FEM-RAFA\RAFAAPI\ReportAFaultAPI\bin\Release\net5.0\ReportAFaultAPI.runtimeconfig.json", "JSON", 0, 0, 14, 0, 0, 0, 14
"c:\Users\Lemuel\VsCodeProjects\FEM-RAFA\RAFAAPI\ReportAFaultAPI\bin\Release\net5.0\appsettings.Development.json", "JSON", 0, 0, 9, 0, 0, 1, 10
"c:\Users\Lemuel\VsCodeProjects\FEM-RAFA\RAFAAPI\ReportAFaultAPI\bin\Release\net5.0\appsettings.json", "JSON", 0, 0, 49, 0, 1, 0, 50
"c:\Users\Lemuel\VsCodeProjects\FEM-RAFA\RAFAAPI\ReportAFaultAPI\bin\Release\net5.0\publish\ReportAFaultAPI.deps.json", "JSON", 0, 0, 6979, 0, 0, 0, 6979
"c:\Users\Lemuel\VsCodeProjects\FEM-RAFA\RAFAAPI\ReportAFaultAPI\bin\Release\net5.0\publish\ReportAFaultAPI.runtimeconfig.json", "JSON", 0, 0, 14, 0, 0, 0, 14
"c:\Users\Lemuel\VsCodeProjects\FEM-RAFA\RAFAAPI\ReportAFaultAPI\bin\Release\net5.0\publish\appsettings.Development.json", "JSON", 0, 0, 9, 0, 0, 1, 10
"c:\Users\Lemuel\VsCodeProjects\FEM-RAFA\RAFAAPI\ReportAFaultAPI\bin\Release\net5.0\publish\appsettings.json", "JSON", 0, 0, 49, 0, 1, 0, 50
"c:\Users\Lemuel\VsCodeProjects\FEM-RAFA\RAFAAPI\ReportAFaultAPI\obj\Debug\net5.0\.NETCoreApp,Version=v5.0.AssemblyAttributes.cs", "C#", 3, 0, 0, 0, 1, 1, 5
"c:\Users\Lemuel\VsCodeProjects\FEM-RAFA\RAFAAPI\ReportAFaultAPI\obj\Debug\net5.0\ReportAFaultAPI.AssemblyInfo.cs", "C#", 9, 0, 0, 0, 9, 5, 23
"c:\Users\Lemuel\VsCodeProjects\FEM-RAFA\RAFAAPI\ReportAFaultAPI\obj\Debug\net5.0\ReportAFaultAPI.GeneratedMSBuildEditorConfig.editorconfig", "Properties", 0, 0, 0, 10, 0, 1, 11
"c:\Users\Lemuel\VsCodeProjects\FEM-RAFA\RAFAAPI\ReportAFaultAPI\obj\Debug\net5.0\ReportAFaultAPI.MvcApplicationPartsAssemblyInfo.cs", "C#", 3, 0, 0, 0, 9, 5, 17
"c:\Users\Lemuel\VsCodeProjects\FEM-RAFA\RAFAAPI\ReportAFaultAPI\obj\Debug\net5.0\project.razor.json", "JSON", 0, 0, 15622, 0, 0, 0, 15622
"c:\Users\Lemuel\VsCodeProjects\FEM-RAFA\RAFAAPI\ReportAFaultAPI\obj\Debug\net6.0\.NETCoreApp,Version=v6.0.AssemblyAttributes.cs", "C#", 3, 0, 0, 0, 1, 1, 5
"c:\Users\Lemuel\VsCodeProjects\FEM-RAFA\RAFAAPI\ReportAFaultAPI\obj\Debug\net6.0\ReportAFaultAPI.AssemblyInfo.cs", "C#", 9, 0, 0, 0, 9, 5, 23
"c:\Users\Lemuel\VsCodeProjects\FEM-RAFA\RAFAAPI\ReportAFaultAPI\obj\Debug\net6.0\ReportAFaultAPI.GeneratedMSBuildEditorConfig.editorconfig", "Properties", 0, 0, 0, 16, 0, 1, 17
"c:\Users\Lemuel\VsCodeProjects\FEM-RAFA\RAFAAPI\ReportAFaultAPI\obj\Debug\net6.0\ReportAFaultAPI.MvcApplicationPartsAssemblyInfo.cs", "C#", 3, 0, 0, 0, 9, 5, 17
"c:\Users\Lemuel\VsCodeProjects\FEM-RAFA\RAFAAPI\ReportAFaultAPI\obj\Debug\net6.0\project.razor.json", "JSON", 0, 0, 16301, 0, 0, 0, 16301
"c:\Users\Lemuel\VsCodeProjects\FEM-RAFA\RAFAAPI\ReportAFaultAPI\obj\Debug\net6.0\staticwebassets.build.json", "JSON", 0, 0, 11, 0, 0, 0, 11
"c:\Users\Lemuel\VsCodeProjects\FEM-RAFA\RAFAAPI\ReportAFaultAPI\obj\Release\net5.0\.NETCoreApp,Version=v5.0.AssemblyAttributes.cs", "C#", 3, 0, 0, 0, 1, 1, 5
"c:\Users\Lemuel\VsCodeProjects\FEM-RAFA\RAFAAPI\ReportAFaultAPI\obj\Release\net5.0\PubTmp\Out\ReportAFaultAPI.deps.json", "JSON", 0, 0, 6797, 0, 0, 0, 6797
"c:\Users\Lemuel\VsCodeProjects\FEM-RAFA\RAFAAPI\ReportAFaultAPI\obj\Release\net5.0\PubTmp\Out\ReportAFaultAPI.runtimeconfig.json", "JSON", 0, 0, 14, 0, 0, 0, 14
"c:\Users\Lemuel\VsCodeProjects\FEM-RAFA\RAFAAPI\ReportAFaultAPI\obj\Release\net5.0\PubTmp\Out\appsettings.Development.json", "JSON", 0, 0, 9, 0, 0, 1, 10
"c:\Users\Lemuel\VsCodeProjects\FEM-RAFA\RAFAAPI\ReportAFaultAPI\obj\Release\net5.0\PubTmp\Out\appsettings.json", "JSON", 0, 0, 14, 0, 1, 1, 16
"c:\Users\Lemuel\VsCodeProjects\FEM-RAFA\RAFAAPI\ReportAFaultAPI\obj\Release\net5.0\ReportAFaultAPI.AssemblyInfo.cs", "C#", 9, 0, 0, 0, 9, 5, 23
"c:\Users\Lemuel\VsCodeProjects\FEM-RAFA\RAFAAPI\ReportAFaultAPI\obj\Release\net5.0\ReportAFaultAPI.GeneratedMSBuildEditorConfig.editorconfig", "Properties", 0, 0, 0, 10, 0, 1, 11
"c:\Users\Lemuel\VsCodeProjects\FEM-RAFA\RAFAAPI\ReportAFaultAPI\obj\Release\net5.0\ReportAFaultAPI.MvcApplicationPartsAssemblyInfo.cs", "C#", 3, 0, 0, 0, 9, 5, 17
"c:\Users\Lemuel\VsCodeProjects\FEM-RAFA\RAFAAPI\ReportAFaultAPI\obj\Release\net5.0\ReportAFaultAPI.deps.json", "JSON", 0, 0, 6979, 0, 0, 0, 6979
"c:\Users\Lemuel\VsCodeProjects\FEM-RAFA\RAFAAPI\ReportAFaultAPI\obj\ReportAFaultAPI.csproj.EntityFrameworkCore.targets", "XML", 0, 25, 0, 0, 0, 1, 26
"c:\Users\Lemuel\VsCodeProjects\FEM-RAFA\RAFAAPI\ReportAFaultAPI\obj\ReportAFaultAPI.csproj.nuget.dgspec.json", "JSON", 0, 0, 121, 0, 0, 0, 121
"c:\Users\Lemuel\VsCodeProjects\FEM-RAFA\RAFAAPI\ReportAFaultAPI\obj\ReportAFaultAPI.csproj.nuget.g.props", "XML", 0, 30, 0, 0, 0, 0, 30
"c:\Users\Lemuel\VsCodeProjects\FEM-RAFA\RAFAAPI\ReportAFaultAPI\obj\ReportAFaultAPI.csproj.nuget.g.targets", "XML", 0, 6, 0, 0, 0, 0, 6
"c:\Users\Lemuel\VsCodeProjects\FEM-RAFA\RAFAAPI\ReportAFaultAPI\obj\project.assets.json", "JSON", 0, 0, 10785, 0, 0, 0, 10785
"c:\Users\Lemuel\VsCodeProjects\FEM-RAFA\RAFAAPI\publish\ReportAFaultAPI.deps.json", "JSON", 0, 0, 6797, 0, 0, 0, 6797
"c:\Users\Lemuel\VsCodeProjects\FEM-RAFA\RAFAAPI\publish\ReportAFaultAPI.runtimeconfig.json", "JSON", 0, 0, 13, 0, 0, 0, 13
"c:\Users\Lemuel\VsCodeProjects\FEM-RAFA\RAFAAPI\publish\appsettings.Development.json", "JSON", 0, 0, 9, 0, 0, 1, 10
"c:\Users\Lemuel\VsCodeProjects\FEM-RAFA\RAFAAPI\publish\appsettings.json", "JSON", 0, 0, 14, 0, 1, 1, 16
"Total", "-", 1421, 112, 82025, 36, 349, 297, 84240